# 种族和政体
Trait - 特质
Ethic - 道德观;道德(的);道德准则
Ethos - 道德准则
Collectivism - 集体本位论
Collectivist - 集体本位者;集体本位(的);集体本位论
Individualism - 个体本位论
Individualist - 个体本位者;个体本位(的);个体本位论
Xenophobia - 排外
Xenophobe - 排外者;排外(的)
Xenophobic - 排外(的)
Xenophilia - 亲外
Xenophile - 亲外者;亲外(的)
Militarism - 军国主义
Militarist - 军国主义者;军国主义(的)
Militaristic - 军国主义(的)
Pacifism - 和平主义
Pacifist - 和平主义者;和平主义(的)
Pacifistic - 和平主义(的)
Spiritualism - 精神主义
Spiritualist - 精神主义者
Spiritualistic - 精神主义(的)
Materialism - 物质主义
Materialist - 物质主义者
Materialistic - 物质主义(的)
Neutral - 中立
Authoritarianism - 威权主义
Egalitarianism - 平等主义

# 事件名词
Curators - 博物馆署
Riggan - 瑞玵
XuraCorp - 旭然集团
Muutagan - 穆塔钢
Drake - 龙兽
Pantagruel - 庞大固埃
Gargantua - 高康大
Stellar Devourer - 噬星者

Tiyanki - 天凯
Cybrex - 赛博霸王
Void Cloud - 虚空之云
Space Amoeba - 太空阿米巴

Javorian Pox - 枫痘   # 原来翻译成 杰法利亚瘟疫 和 贾沃安瘟疫 不统一，所以干脆瞎起了个易读的名字。枫来自克罗地亚语中的 Javor 痘指 Pox 。

#行为
Survey - 勘察
Jump - 跃迁
Uplift - 开化
Purge - 肃清;大清洗
Purging - 肃清;肃清中;大清洗
Disassemble - ?
Displace - 驱离

Click - 点击
Right Click - 右键点击

# 科技/武器
Deflector - 偏向器
X-ray Laser - X射线激光
Garrison - 驻军
Drone - 无人机
Droid - 人型机器人
Projectile (weapon) - 投射武器
Warp - 曲速
HyperDrive - 超空间驱动
JumpDrive - 折跃引擎
Psionic - 灵能
FTL - 超光速引擎(FTL)
Hyperlane - 超空间航道

#外交
League of Non-Aligned Powers - 不结盟力量联合体
Tributary - 藩属国
Vassal - 臣属国
Thrall - 仆从国
Dominion - 自治领
Signatory - 协约国
Satellite - 卫星国
Lord - 宗主国
Subject - 附庸
Embassy - 大使馆;外交使节

#名词
modifier - 修正;调整因素
Government - 政体;政府
government form - 政体;政府形式
government type - 政体;政府形式
Edict - 法令
committee - 委员会
council - 议会
cost - 消耗
lesser lifeform - 低级生物
Authority - 权力制度
Civic - 公民性
Tradition - 传统
Ascension Perk - 飞升特典
(Orbital) Habitat - 轨道栖所
Shroud - 帷幕
Cybernetic/Cyborg - 赛博族/赛博人 具体看语境
(Cybernetic) Implants - (赛博)内植物/内植部件

Hotkey - 快捷键
Habitability - 宜居性
Subspace - 亚空间
Homeworld - 母星
Frontier - 边境
Ship - 舰船
Species - 种族
Sector - 星域
Spaceport - 太空港
Station - 基地
Power - 能量
Energy (credits) - 能源(点数)
Unity - 凝聚力

Xeno - 异星;异族;异种;异形  #视语境
Dimension(al) - 次元;维度(作第n维度时用)
Extradimension(al) - 异次元

Fallen Empire - 堕落帝国

Molten World - 熔岩世界
Frozen World - 寒冰世界
Barren World - 荒芜世界
Desert World - 沙漠世界
Arid World - 旱地世界
Tundra World - 冻原世界
Continental World - 大陆世界
Tropical World - 热带世界
Ocean World - 海洋世界
Arctic World - 极地世界
Alpine World - 高寒世界
Savannah World - 草原世界
Toxic World - 剧毒世界
Gaia World - 盖娅世界

megastructure - 巨型结构